"a" = (/turf,/area/outside)
"b" = (/turf/mapping/floor,/area/outside)
"c" = (/structure/controls,/turf/mapping/floor,/area/outside)
"d" = (/turf/mapping/supports,/area/outside)
"e" = (/turf/mapping/wall/metal,/area)
"f" = (/turf/mapping/wall,/area)
"g" = (/structure/door,/turf/mapping/floor,/area)
"h" = (/structure/table,/turf/mapping/floor/metal,/area)
"i" = (/turf/mapping/floor/metal,/area)
"j" = (/structure/ladder/up,/turf/mapping/floor,/area)
"k" = (/turf/mapping/floor,/area)
"l" = (/structure/table,/turf/mapping/floor,/area)
"m" = (/structure/lamp{pixel_y = 32},/structure/table,/turf/mapping/floor,/area)
"n" = (/structure/lamp{pixel_x = -32},/structure/table,/turf/mapping/floor/metal,/area)
"o" = (/structure/lamp{pixel_x = 32},/structure/table,/turf/mapping/floor/metal,/area)
"p" = (/structure/door/metal,/turf/mapping/floor/metal,/area)
"q" = (/turf/mapping/window,/area)
"r" = (/structure/lamp{pixel_x = 32},/turf/mapping/floor,/area)
"s" = (/structure/lamp{pixel_x = -32},/turf/mapping/floor,/area)
"t" = (/structure/marker,/turf/mapping/floor,/area)
"u" = (/structure/table,/item/stack/bandages,/turf/mapping/floor,/area)
"v" = (/structure/lamp{pixel_y = -32},/structure/table,/item/stack/bandages,/turf/mapping/floor,/area)
"w" = (/structure/table,/item/medical/sutures,/turf/mapping/floor,/area)
"x" = (/structure/table,/item/weapon/gun/revolver,/turf/mapping/floor,/area)
"y" = (/structure/table,/item/weapon/sword,/turf/mapping/floor,/area)
"z" = (/structure/ladder/down,/turf/mapping/floor,/area/outside)

(1,1,1) = {"
aaaaaaaaaaaaaaaaaaaaaaaaa
aaaaaaaaaaaaaaaaaaaaaaaaa
aaaaaaaaaaaaaabbbcbbbaaaa
aaadddddddddddbbbbbbbaaaa
aaaeeeeeeefffffffgffffaaa
aaaehiiihefjklmlkkkkkfaaa
aaaeniiioefkkkkkkkkkkfaaa
aaaehiiihefkkkkkkkkkkfaaa
aaaehiiihefkkkkkkkkkkfaaa
aaaeeepeeeffqqffkkkkrfaaa
aaafllkllffkkkkkkkkkkfaaa
aaafkkkkkfkkkkkkkkkkkfaaa
aaafkkkkkkkkkkkkkkkkkfaaa
aaafsktkkkkkkkkkkkkkkfaaa
aaafkkkkkkkkkkkkkkkkkfaaa
aaafkkkkkfkuvwxylkkkkfaaa
aaafffqfffffffffffqfffaaa
aaaaaaaaaaaaaaaaaaaaaaaaa
aaaaaaaaaaaaaaaaaaaaaaaaa
aaaaaaaaaaaaaaaaaaaaaaaaa
"}

(1,1,2) = {"
aaaaaaaaaaaaaaaaaaaaaaaaa
aaaaaaaaaaaaaaaaaaaaaaaaa
aaaaaaaaaaaaaaaaaaaaaaaaa
aaaaaaaaaaaaaaaaaaaaaaaaa
aaabbbbbbbbbbbbbbbbbbbbaa
aaabbbbbbbbzbbbbbbbbbbbaa
aaabbbbbbbbbbbbbbbbbbbbaa
aaabbbbbbbbbbbbbbbbbbbbaa
aaabbbbbbbbbbbbbbbbbbbbaa
aaabbbbbbbbbbbbbbbbbbbbaa
aaabbbbbbbbbbbbbbbbbbbbaa
aaabbbbbbbbbbbbbbbbbbbbaa
aaabbbbbbbbbbbbbbbbbbbbaa
aaabbbbbbbbbbbbbbbbbbbbaa
aaabbbbbbbbbbbbbbbbbbbbaa
aaabbbbbbbbbbbbbbbbbbbbaa
aaabbbbbbbbbbbbbbbbbbbbaa
aaaaaaaaaaaaaaaaaaaaaaaaa
aaaaaaaaaaaaaaaaaaaaaaaaa
aaaaaaaaaaaaaaaaaaaaaaaaa
"}
