"a" = (/turf/sky,/area)
"b" = (/tile/floor,/tile/wall,/turf/sky,/area)
"c" = (/tile/floor,/item/clothing/coat,/turf/sky,/area)
"d" = (/tile/floor,/item/clothing/shirt,/turf/sky,/area)
"e" = (/tile/floor,/item/clothing/trousers,/turf/sky,/area)
"f" = (/tile/floor,/structure/bed,/turf/sky,/area)
"g" = (/tile/floor,/turf/sky,/area)
"h" = (/tile/floor,/item/clothing/coat/transparent,/item/clothing/coat/transparent,/item/clothing/coat/transparent,/item/clothing/coat/transparent,/item/clothing/coat/transparent,/item/clothing/coat/transparent,/item/clothing/coat/transparent,/item/clothing/coat/transparent,/item/clothing/coat/transparent,/item/clothing/coat/transparent,/item/clothing/coat/transparent,/item/clothing/coat/transparent,/item/clothing/coat/transparent,/item/clothing/coat/transparent,/item/clothing/coat/transparent,/turf/sky,/area)
"i" = (/tile/floor,/item/clothing/coat/transparent,/turf/sky,/area)
"j" = (/tile/floor,/structure/marker,/turf/sky,/area)
"k" = (/tile/floor/metal,/tile/wall/metal,/turf/sky,/area)
"l" = (/tile/floor/metal,/turf/sky,/area)

(1,1,1) = {"
aaaaaaaaaaaaaaaaaaaaaaaaa
aaaaaaaaaaaaaaaaaaaaaaaaa
aaaaaaaaaaaaaaaaaaaaaaaaa
aaaaaaaaaaaaaaaaaaaaaaaaa
aaaaaaaaaaaaaaaaaaaaaaaaa
aaaaaaaaaaaaaaaaaaaaaaaaa
aaaaaaaaaaaaaaaaaaaaaaaaa
aaaaaaaaaaaaaaaaaaaaaaaaa
aaaaaaaaaaaaaaaaaaaaaaaaa
aaaaaaaaaaaaaaaaaaaaaaaaa
aaaaaaaaaaaaaaaaaaaaaaaaa
aaaaaaaaaaaaaaaaaaaaaaaaa
aaaaaaaaaaaaaaaaaaaaaaaaa
aaaaaaaaaaaaaaaaaaaaaaaaa
aaaaaaaaaaaaaaaaaaaaaaaaa
aaaaaaaaaaaaaaaaaaaaaaaaa
aaaaaaaaaaaaaaaaaaaaaaaaa
aabbbbbbaaaaaaaaaaaaaaaaa
aabcdefbaaaaaaaaaaaaaaaaa
aagcdeghaaaaaaaaaaaaaaaaa
aagijgggaaaaaaaaaaaaaaaaa
aakllllkaaaaaaaaaaaaaaaaa
aakkkkkkaaaaaaaaaaaaaaaaa
aaaaaaaaaaaaaaaaaaaaaaaaa
aaaaaaaaaaaaaaaaaaaaaaaaa
"}
