"aa" = (/turf,/area/outside)
"ab" = (/turf/mapping/floor/metal,/area/outside)
"ac" = (/structure/pipe{tag = "icon-6"; icon_state = "6"},/turf/mapping/supports,/area/outside)
"ad" = (/structure/pipe{tag = "icon-12"; icon_state = "12"},/turf/mapping/supports,/area/outside)
"ae" = (/structure/pipe{tag = "icon-10"; icon_state = "10"},/turf/mapping/supports,/area/outside)
"af" = (/turf/mapping/supports,/area/outside)
"ag" = (/structure/pipe{tag = "icon-3"; icon_state = "3"},/turf/mapping/supports,/area/outside)
"ah" = (/turf/mapping/wall/metal,/area)
"ai" = (/structure/door/metal,/turf/mapping/floor/metal,/area)
"aj" = (/structure/pipe{tag = "icon-4"; icon_state = "4"},/structure/pipe{tag = "icon-16"; icon_state = "16"},/turf,/area/outside)
"ak" = (/structure/pipe{tag = "icon-13"; icon_state = "13"},/turf/mapping/supports,/area/outside)
"al" = (/turf/mapping/floor/metal,/area)
"am" = (/structure/pipe{tag = "icon-11"; icon_state = "11"},/turf/mapping/floor/metal,/area)
"an" = (/structure/ladder/up,/turf/mapping/floor/metal,/area)
"ao" = (/structure/lamp{pixel_y = 32},/turf/mapping/floor/metal,/area)
"ap" = (/structure/pipe{tag = "icon-9"; icon_state = "9"},/turf/mapping/floor/metal,/area)
"aq" = (/structure/lamp{pixel_x = -32},/turf/mapping/floor/metal,/area)
"ar" = (/structure/pipe{tag = "icon-2"; icon_state = "2"},/structure/pipe{tag = "icon-16"; icon_state = "16"},/turf/mapping/floor/metal,/area)
"as" = (/structure/pipe{tag = "icon-32"; icon_state = "32"},/structure/pipe{tag = "icon-2"; icon_state = "2"},/turf/mapping/floor/metal,/area)
"at" = (/structure/pipe{tag = "icon-6"; icon_state = "6"},/turf/mapping/floor/metal,/area)
"au" = (/structure/pipe{tag = "icon-12"; icon_state = "12"},/turf/mapping/floor/metal,/area)
"av" = (/structure/pipe{tag = "icon-13"; icon_state = "13"},/turf/mapping/floor/metal,/area)
"aw" = (/structure/pipe{tag = "icon-32"; icon_state = "32"},/structure/pipe{tag = "icon-8"; icon_state = "8"},/turf/mapping/floor/metal,/area)
"ax" = (/turf/mapping/frame/metal,/area)
"ay" = (/structure/pipe{tag = "icon-3"; icon_state = "3"},/turf/mapping/floor/metal,/area)
"az" = (/structure/pipe{tag = "icon-5"; icon_state = "5"},/turf/mapping/floor/metal,/area)
"aA" = (/structure/pipe{tag = "icon-12"; icon_state = "12"},/turf/mapping/frame/metal,/area)
"aB" = (/structure/lamp{pixel_x = 32},/turf/mapping/floor/metal,/area)
"aC" = (/structure/pipe{tag = "icon-1"; icon_state = "1"},/structure/pipe{tag = "icon-16"; icon_state = "16"},/turf/mapping/floor/metal,/area)
"aD" = (/turf/mapping/window/iron,/area)
"aE" = (/structure/door/glass,/turf/mapping/floor/metal,/area)
"aF" = (/structure/pipe{tag = "icon-32"; icon_state = "32"},/structure/pipe{tag = "icon-4"; icon_state = "4"},/turf/mapping/supports,/area/outside)
"aG" = (/structure/pipe{tag = "icon-13"; icon_state = "13"},/structure/pipe{tag = "icon-16"; icon_state = "16"},/turf/mapping/floor/metal,/area)
"aH" = (/structure/pipe{tag = "icon-12"; icon_state = "12"},/structure/lamp{pixel_y = -32},/turf/mapping/floor/metal,/area)
"aI" = (/structure/pipe{tag = "icon-8"; icon_state = "8"},/structure/pipe{tag = "icon-16"; icon_state = "16"},/turf/mapping/floor/metal,/area)
"aJ" = (/structure/lamp{pixel_y = -32},/turf/mapping/floor/metal,/area)
"aK" = (/turf/mapping/frame,/area/outside)
"aL" = (/turf/mapping/floor,/area/outside)
"aM" = (/turf/mapping/wall,/area)
"aN" = (/turf/mapping/window,/area)
"aO" = (/structure/door/glass,/turf/mapping/floor,/area)
"aP" = (/structure/controls,/turf/mapping/floor/metal,/area)
"aQ" = (/structure/ladder/up,/turf/mapping/floor,/area)
"aR" = (/structure/ladder/down,/turf/mapping/floor,/area)
"aS" = (/turf/mapping/floor,/area)
"aT" = (/structure/box/locked,/turf/mapping/floor,/area)
"aU" = (/structure/table,/turf/mapping/floor/metal,/area)
"aV" = (/structure/lamp{pixel_x = -32},/structure/table,/turf/mapping/floor/metal,/area)
"aW" = (/structure/lamp{pixel_x = 32},/structure/table,/turf/mapping/floor/metal,/area)
"aX" = (/structure/table,/turf/mapping/floor,/area)
"aY" = (/structure/lamp{pixel_x = -32},/turf/mapping/floor,/area)
"aZ" = (/structure/table,/structure/lamp,/turf/mapping/floor,/area)
"ba" = (/structure/pipe{tag = "icon-2"; icon_state = "2"},/structure/pipe{tag = "icon-16"; icon_state = "16"},/turf/mapping/floor,/area)
"bb" = (/structure/pipe{tag = "icon-32"; icon_state = "32"},/structure/pipe{tag = "icon-1"; icon_state = "1"},/turf/mapping/floor,/area)
"bc" = (/structure/marker,/turf/mapping/floor,/area)
"bd" = (/structure/pipe{tag = "icon-6"; icon_state = "6"},/turf/mapping/floor,/area)
"be" = (/structure/pipe{tag = "icon-10"; icon_state = "10"},/turf/mapping/floor,/area)
"bf" = (/tile/support,/turf/mapping,/area)
"bg" = (/turf/mapping,/area)
"bh" = (/structure/pipe{tag = "icon-32"; icon_state = "32"},/structure/pipe{tag = "icon-4"; icon_state = "4"},/turf/mapping/floor,/area)
"bi" = (/structure/pipe{tag = "icon-13"; icon_state = "13"},/turf/mapping/floor,/area)
"bj" = (/structure/pipe{tag = "icon-11"; icon_state = "11"},/turf/mapping/floor,/area)
"bk" = (/structure/lamp{pixel_y = -32},/turf/mapping/floor,/area)
"bl" = (/structure/pipe{tag = "icon-32"; icon_state = "32"},/structure/pipe{tag = "icon-2"; icon_state = "2"},/turf/mapping/floor,/area)
"bm" = (/structure/lamp{pixel_y = -32},/turf/mapping,/area)
"bn" = (/structure/pipe{tag = "icon-5"; icon_state = "5"},/turf/mapping/supports,/area/outside)
"bo" = (/structure/pipe{tag = "icon-9"; icon_state = "9"},/turf/mapping/supports,/area/outside)
"bp" = (/turf/mapping/frame/metal,/area/outside)

(1,1,1) = {"
aaaaaaaaaaaaaaaaaaaaaaaaaaaaaaaaaaaaaaaaaaaaaaaaaa
aaaaaaaaaaaaaaaaaaaaaaaaaaaaaaaaaaaaaaaaaaaaaaaaaa
aaaaaaaaaaaaaaaaaaaaaaaaaaaaabababababababaaaaaaaa
aaaaacadadadadadadadaeafafafabababababababaaaaaaaa
aaaaagahahahahahahahahahahahahahahaiahahahahaaaaaa
aaajakahalalalalalahamanalalaoalalalalalalahaaaaaa
aaaaafahalalalalalahapalalalalalalalalalalahaaaaaa
aaaaafahaqalalalalaialalaralasalalalalalalahaaaaaa
aaaaafahalalalalalahatauavauavawalalalalalahaaaaaa
aaaaafahahahaiahahahahaxaxaxaxahalalalalalahaaaaaa
aaaaafahayalalaoazaAamalalalalalalalalalaBahaaaaaa
aaaaafahayalalalalaxaCalalalalalalalalalalahaaaaaa
aaaaafaDayalalalalaxalalalalalalalalalalalahaaaaaa
aaaaafaDayalalalalaEalalalalalalalalalalalahaaaaaa
aaaaafahayalalalalaxalalalalalalalalalalalahaaaaaa
aaaaaFahaGauaHauauaAaIalalalalaJalalalalalahaaaaaa
aaaaaaahahahahahahahahahahaDahahahaDahahahahaaaaaa
aaaaaaaaaaaaaaaaaaaaaaaaaaaaaaaaaaaaaaaaaaaaaaaaaa
aaaaaaaaaaaaaaaaaaaaaaaaaaaaaaaaaaaaaaaaaaaaaaaaaa
aaaaaaaaaaaaaaaaaaaaaaaaaaaaaaaaaaaaaaaaaaaaaaaaaa
"}

(1,1,2) = {"
aaaaaaaaaaaaaaaaaaaaaaaaaaaaaaaaaaaaaaaaaaaaaaaaaa
aaaaaaaaaaaaaaaaaaaaaaaaaaaaaaaaaaaaaaaaaaaaaaaaaa
aaaaaaaaaaaaaaaaaaaaafafafafafafafafafafafafafafaa
aaaaaaaaaaaaaaaaaaaaaKaLaLaLaLaLaLaLaLaLaLaLaLafaa
aaaaaaahahaDaDaDahahaMaNaOaMaMaNaNaNaNaNaMaMaLafaa
aaaaaaahalalaPalalahaQaRaSaMaSaSaSaSaSaSaTaMaLafaa
aaaaaaahaUalalalaUahaSaSaSaNaSaSaSaSaSaSaSaNaLafaa
aaaaaaahaValalalaWahaSaSaSaOaSaSaXaXaXaSaSaNaLafaa
aaaaaaahaUalalalaUahaYaSaSaOaSaSaXaZaXaSaSaNaLafaa
aaaaaaahalalalalalahaSaSaSaNaSaSaSaSaSaSaSaNaLafaa
aaaaaaahaDahaiahaDahbaaSaSaMaSaSaSaSaSaSaSaMaLafaa
aaaaaaaMaXaXaSaXaXaXbbaSaSaMaMaNaNaNaNaNaMaMaLafaa
aaaaaaaMaYaSaSaSaSaSaSaSaSaSaSaSaSaSaSaSaSaMaLafaa
aaaaaaaMaSaSbcaSaSaSaSaSaSaSaSaSaSaSaSaSaSaNaLafaa
aaaaaaaNaSbdbeaSaSaSaSbfbfbgaSaSaSaSaSaSaSaNaLafaa
aaaaaaaMbhbibjaSaSbkblaSbfbmbgaXaXaXaXaXaXaMaLafaa
aaaaaaaMaMaNaMaMaMaMaMaNaMaMaMaNaNaNaNaNaMaMaKafaa
aaaaaaaaaaaabnadadadboaaaaaaaaaaaaaaaaaaaaaaaaaaaa
aaaaaaaaaaaaaaaaaaaaaaaaaaaaaaaaaaaaaaaaaaaaaaaaaa
aaaaaaaaaaaaaaaaaaaaaaaaaaaaaaaaaaaaaaaaaaaaaaaaaa
"}

(1,1,3) = {"
aaaaaaaaaaaaaaaaaaaaaaaaaaaaaaaaaaaaaaaaaaaaaaaaaa
aaaaaaaaaaaaaaaaaaaaaaaaaaaaaaaaaaaaaaaaaaaaaaaaaa
aaaaaaaaaaaaaaaaaaaaaaaaaaaaaaaaaaaaaaaaaaaaaaaaaa
aaaaaaaaaaaaaaaaaaaaaaaaaaaaaaaaaaaaaaaaaaaaaaaaaa
aaaaaabpbpbpaLaLaLaMaMaMaLaLaLaLaLaLaLbpbpbpaaaaaa
aaaaaabpababaLaLaLaMaRaMaLaLaLaLaLaLaLababbpaaaaaa
aaaaaabpabaLaLaLaLaMaSaMaLaLaLaLaLaLaLaLabbpaaaaaa
aaaaaaaLaLaLaLaLaLaLaLaLaLaLaLaLaLaLaLaLaLaLaaaaaa
aaaaaaaLaLaLaLaLaLaLaLaLaLaLaLaLaLaLaLaLaLaLaaaaaa
aaaaaaaLaLaLaLaLaLaLaLaLaLaLaLaLaLaLaLaLaLaLaaaaaa
aaaaaaaLaLaLaLaLaLaLaLaLaLaLaLaLaLaLaLaLaLaLaaaaaa
aaaaaaaLaLaLaLaLaLaLaLaLaLaLaLaLaLaLaLaLaLaLaaaaaa
aaaaaaaLaLaLaLaLaLaLaLaLaLaLaLaLaLaLaLaLaLaLaaaaaa
aaaaaaaLaLaLaLaLaLaLaLaLaLaLaLaLaLaLaLaLaLaLaaaaaa
aaaaaabpabaLaLaLaLaLaLaLaLaLaLaLaLaLaLaLabbpaaaaaa
aaaaaabpababaLaLaLaLaLaLaLaLaLaLaLaLaLababbpaaaaaa
aaaaaabpbpbpaLaLaLaLaLaLaLaLaLaLaLaLaLbpbpbpaaaaaa
aaaaaaaaaaaaaaaaaaaaaaaaaaaaaaaaaaaaaaaaaaaaaaaaaa
aaaaaaaaaaaaaaaaaaaaaaaaaaaaaaaaaaaaaaaaaaaaaaaaaa
aaaaaaaaaaaaaaaaaaaaaaaaaaaaaaaaaaaaaaaaaaaaaaaaaa
"}
