"a" = (/turf/sky,/area)
"b" = (/tile/floor,/tile/wall,/turf/sky,/area)
"c" = (/tile/floor,/turf/sky,/area)
"d" = (/tile/floor,/item/test,/turf/sky,/area)
"e" = (/tile/floor,/structure/marker,/turf/sky,/area)
"f" = (/tile/floor,/item/test/coat,/turf/sky,/area)
"g" = (/tile/floor/metal,/tile/wall/metal,/turf/sky,/area)
"h" = (/tile/floor/metal,/turf/sky,/area)

(1,1,1) = {"
aaaaaaaaaaaaaaaaaaaaaaaaa
aaaaaaaaaaaaaaaaaaaaaaaaa
aaaaaaaaaaaaaaaaaaaaaaaaa
aaaaaaaaaaaaaaaaaaaaaaaaa
aaaaaaaaaaaaaaaaaaaaaaaaa
aaaaaaaaaaaaaaaaaaaaaaaaa
aaaaaaaaaaaaaaaaaaaaaaaaa
aaaaaaaaaaaaaaaaaaaaaaaaa
aaaaaaaaaaaaaaaaaaaaaaaaa
aaaaaaaaaaaaaaaaaaaaaaaaa
aaaaaaaaaaaaaaaaaaaaaaaaa
aaaaaaaaaaaaaaaaaaaaaaaaa
aaaaaaaaaaaaaaaaaaaaaaaaa
aaaaaaaaaaaaaaaaaaaaaaaaa
aaaaaaaaaaaaaaaaaaaaaaaaa
aaaaaaaaaaaaaaaaaaaaaaaaa
aaaaaaaaaaaaaaaaaaaaaaaaa
aabbbbbbaaaaaaaaaaaaaaaaa
aabccccbaaaaaaaaaaaaaaaaa
aaccddccaaaaaaaaaaaaaaaaa
aaccefccaaaaaaaaaaaaaaaaa
aaghhhhgaaaaaaaaaaaaaaaaa
aaggggggaaaaaaaaaaaaaaaaa
aaaaaaaaaaaaaaaaaaaaaaaaa
aaaaaaaaaaaaaaaaaaaaaaaaa
"}
