"a" = (/turf,/area/outside)
"b" = (/turf/mapping/floor,/area/outside)
"c" = (/turf/mapping/supports,/area/outside)
"d" = (/turf/mapping/wall/metal,/area)
"e" = (/turf/mapping/wall,/area)
"f" = (/structure/door,/turf/mapping/floor,/area)
"g" = (/turf/mapping/floor/metal,/area)
"h" = (/structure/ladder_up,/turf/mapping/floor,/area)
"i" = (/turf/mapping/floor,/area)
"j" = (/structure/door/metal,/turf/mapping/floor/metal,/area)
"k" = (/turf/mapping/window,/area)
"l" = (/structure/marker,/turf/mapping/floor,/area)
"m" = (/structure/ladder_down{pixel_y = 12},/turf/mapping/floor,/area/outside)

(1,1,1) = {"
aaaaaaaaaaaaaaaaaaaaaaaaa
aaaaaaaaaaaaaaaaaaaaaaaaa
aaaaaaaaaaaaaabbbbbbbaaaa
aaacccccccccccbbbbbbbaaaa
aaadddddddeeeeeeefeeeeaaa
aaadgggggdehiiiiiiiiieaaa
aaadgggggdeiiiiiiiiiieaaa
aaadgggggdeiiiiiiiiiieaaa
aaadgggggdeiiiiiiiiiieaaa
aaadddjdddeekkeeiiiiieaaa
aaaeiiiiieeiiiiiiiiiieaaa
aaaeiiiiieiiiiiiiiiiieaaa
aaaeiiiiiiiiiiiiiiiiieaaa
aaaeiiliiiiiiiiiiiiiieaaa
aaaeiiiiiiiiiiiiiiiiieaaa
aaaeiiiiieiiiiiiiiiiieaaa
aaaeeekeeeeeeeeeeekeeeaaa
aaaaaaaaaaaaaaaaaaaaaaaaa
aaaaaaaaaaaaaaaaaaaaaaaaa
aaaaaaaaaaaaaaaaaaaaaaaaa
"}

(1,1,2) = {"
aaaaaaaaaaaaaaaaaaaaaaaaa
aaaaaaaaaaaaaaaaaaaaaaaaa
aaaaaaaaaaaaaaaaaaaaaaaaa
aaaaaaaaaaaaaaaaaaaaaaaaa
aaabbbbbbbbbbbbbbbbbbbbaa
aaabbbbbbbbmbbbbbbbbbbbaa
aaabbbbbbbbbbbbbbbbbbbbaa
aaabbbbbbbbbbbbbbbbbbbbaa
aaabbbbbbbbbbbbbbbbbbbbaa
aaabbbbbbbbbbbbbbbbbbbbaa
aaabbbbbbbbbbbbbbbbbbbbaa
aaabbbbbbbbbbbbbbbbbbbbaa
aaabbbbbbbbbbbbbbbbbbbbaa
aaabbbbbbbbbbbbbbbbbbbbaa
aaabbbbbbbbbbbbbbbbbbbbaa
aaabbbbbbbbbbbbbbbbbbbbaa
aaabbbbbbbbbbbbbbbbbbbbaa
aaaaaaaaaaaaaaaaaaaaaaaaa
aaaaaaaaaaaaaaaaaaaaaaaaa
aaaaaaaaaaaaaaaaaaaaaaaaa
"}
